11111111111
1C0C0C101C1
1011101C101
1C0P1C000E1
11111111111