111111111111111
100C1C00100C1E1
1010101C1010101
1P10C0100C100C1
111111111111111