1111111111111
100100000C001
1000011111C01
1PCE1100C0001
1111111111111
